1###########################
2#           #             #
3#        ####             #
3#        # O    #         #
4# #  #   #  #             #
5#      ###### ##          #
6# ##    ##   # #          #
7#           #  #      #   #
8#       ##     #          #
9#              #  #       #
0# X    #                  #
1###########################